###############
#       # # # #
### ### # # # #
#   #   # #   #
# ##### # ### #
#     #       #
###############

#######################
#   #       #     #   #
### ### # ### # ##### #
#       #     #       #
# # ####### ### # #####
# #   #     # # #     #
# ##### ### # ##### # #
# #     #         # # #
#######################

###############################
# #   #       # #         # # #
# ### ### ##### ######### # # #
#     #     # #           #   #
### ##### # # # ##### # ### ###
#   #   # #   # #     # #     #
### # # # ### # # # ### # ### #
#   # # # #   # # # # #   #   #
# # # # # # ### # # # ##### # #
# #   #   #   # # # #       # #
# # # # ### # # ##### # ##### #
# # # #   # #     #   #   #   #
###############################

#######################################
#   # #       #       #       #   #   #
### # # ### # # # # # ### ####### # ###
#   # # #   # # # # #     #       #   #
### # ####### ######### ##### ### # ###
#     # #       #     #   # # # # #   #
# ##### ####### ##### # ### # # # ### #
# #     # #           #     #   #   # #
# # ##### # # ##### # ##### ### ### # #
#         # # #   # # # #       #     #
### # # ### ##### # ### # ##### ##### #
#   # #   #   # #   #   #   # # #     #
####### ### ### ### # ##### # ##### ###
#           #   # #           # #     #
# # ####### # ### ##### ### # # ##### #
# #     #       #       #   # #       #
#######################################

###################################################
#   #         #   #   # #   #   #             #   #
### # # ### ##### # ### # ### ### ### ### # ##### #
#     #   #   #   # #   # #   # #   # #   # # # # #
# ######### # ### # ### # ### # # ####### ### # # #
# # # #   # # # #               #   #     #       #
# # # # ##### # ##### ####### ########### ### #####
#   #   #   # # #   #     # # #     #           # #
### # ### ### # # # # ##### # # # # # ########### #
# # #   # # #   # #   #   # #   # #     #       # #
# # # ### # # ### # ##### # # # ##### ### ### # # #
#   #   #     #   # #       # # #       # # # # # #
# # # ### ######### # ##### ##### # ### ### ### # #
# # #     # # #         #   #     # # #       #   #
######### # # # ### # ##### ####### # ### ### # # #
#         # # #   # # #   # #   #   #       #   # #
### ##### # # # ### ### # ### # # # # # ### ##### #
#   # # #     #   #     # #   # # # # # #   #     #
### # # # # # # # ##### # ### ### ##### ####### # #
#   #     # #   #   #   # #           #     #   # #
###################################################

